1111111111
1200100011
1101111011
1101111011
1000000011
1011111111
1000000011
1011110111
1000010031
1111111111