11111111111111111111
12001000100000000001
11011110101111111101
11011110101100000101
10000000101101110101
10111111101111110101
10000000100000000101
10111101111011111101
10000100000000000101
11111111111111111101
10000000000001000001
10111101011101011011
10101101011101011001
10101101011101111101
10100001011100000001
10111111011111111101
10100001000000000101
10101111111111111101
13100000000000000001
11111111111111111111